8,12
------------
>-----------
XXXXXXX-----
-O----------
----XXXXXXXX
----------D-
------------
------------
