10,14
vXDXDXDXDXDXDX
-X-X-X-X-X-X-X
-X-X-X-X-X-X-X
-X-X-X-X-X-X-X
-X-X-X-X-X-X-X
-X-X-X-X-X-X-X
-X-X-X-X-X-X-X
--------------
OXOXOXOXOXOX--
XXXXXXXXXXXXXX