12,20
--------------------
-XX--XX-------------
-X----X-------------
-X----X------XXXXXX-
-XOOOOX------X-DD-X-
-XXXXXX------X----X-
-------------X----XX
-------------X-----X
-------------XDDX--X
-------------XXXX--X
--------------------
-------------------<